a=B
b=R,Y
c=B,G
d=R,B
e=Y
f=R,O
g=Y,R
h=B,R
i=G,Y
j=O,R
k=Y,B
l=Y,G
m=Y,O
n=G,O
o=O
p=B,Y
q=O,Y
r=G,R
s=R,G
t=G,B
u=O,B
v=O,G
w=O,Y,G
x=G,R,G
y=G,Y,G
z=G,B,G
.=G,O,G
<space>=G
<backspace>=R
<newline>=G,R,Y,B